#########################################
##########...#########....###############
######.#......######...#.################
######.##.#...######..##...##############
###.......#...######..#.....#############
###.......#..####.##..#.....#############
###..........###...#..##...##############
###.......#....##.##.####.###############
###.......#..#.......##...###############
######.####.#.#.....###...######.....####
#####..####...#..#####..#............####
###...#########.#####..#.#.....#.....####
#...###########.###....#...#.#.###.######
#.#############.#####...#.#..####...#.###
#.#.....####.......######.##..##......###
#.......####.......#####...##....########
###.....####.......####.........#########
############.......####.....#...#.....###
############.......#####...##.........###
############################....#.....###
#############################...#########
###############################...#######
#########################################
