#########################################
######################...################
#################.##.......##############
######.#########.....####.###############
######.#######....#.###.......###########
###.......####.##.#####.......###########
###.......###..#...####.......###########
###...........##...####.......###########
###.......##.#.#...####.......###########
###.......##...#.#########.##############
######.########...#..#####...#######.####
####...########..###.#######...####...###
###..#########.......#########...###.####
#...##########.....###########.........##
#.#.##########.###############..##......#
#.......####......############..#######.#
#.#.....####.......##########.#.#.......#
###.....####..........#.....#.........###
############.......##.......#####.....###
#############.....#####.....#############
#########################################
#########################################
#########################################
