#########################################
######.#######..........#######...#######
######.######.............#####.#.#######
###.............#########.####..##.######
###.......#.###.######.......#......#####
###.......####...#####...........##.#####
###.........##...#####.......#####...####
######.####..#...#####.......#........###
##.....####..##.#########.####..#.....###
#......####.....#######...####..##...####
#.###.#####.....#######.#..####..##.#####
#.###.#####..##.#######..#.#####....#####
####.....##..##.#########..######...#####
###.......#......#...##...########...####
###..........#...#........#########.#####
###.......#..#...#.#...##.#########.#####
####......#..###########...#######...####
###########..##########.....######...####
###########..##########.....######...####
###########...##########...##############
############..###########################
###########...###########################
#########################################
