#########################################
######.########################....######
######.##########...#########...#.#######
#####......###.......##.....#.###...#####
####.......##..##.##..........##.....####
####..........##...####.....####.....####
####.......#####...##############...#####
#####......#####...###############.######
######.##########.#####...########.######
######.###...####...........######.######
#####..###.#.####.##.....##...#.....#####
###....####..##...####...#######....#####
###.........###.########...#####.....####
#...###...#####.##########.#####.....####
#.#.###.####.......####.......#......####
#.......####.......####.......#..##.#####
#.#.....####.......####..........##...###
###.....####.......####.......##......###
#######################.......##..#...###
################################..#######
###############################..########
#############################...#########
#########################################
