#########################################
##############.#############.....########
#############...#####........#.#.########
############...........##...##......#####
###########....##...##.##.####.......####
##########..##.######...######.......####
###.....#..##...####.....#####.......####
#.#........##...####.....#####.......####
#.......#..##...#####...########.########
#.########..##.###.###########...########
#..########........###########...########
#..########.......#########.#.....#######
#.#########################...###.#######
#.#.....##################..#.###.#######
#.........###.######........#.........###
###.....#..#...##........#..#.........###
##########.##.##..##.....#............###
##########.......#########..#.........###
############.....########..##.........###
###############...###.##..###############
#################.....#..################
#################...##..#################
#########################################
