#########################################
#######.##########...###########.########
#######.#########......########...#######
###.........#####.###.#######......######
###.........###...........#...####.######
###.............###.........#.#.......###
###.........##..###.......#.###.......###
###.........##...##.......#####.......###
#####.#.########..#.......#####.......###
###...#.#########.####.##################
##..........#####..###.###...############
#...........######...#..##....###########
#.##.........###..#####.#..##...#########
#..#......##.....######..#####..#.....###
#####.....##...#########.#####........###
########..###########.......##.##.....###
########..###########.......#..##########
########..###########..........##########
#####.##..###########.......#..##########
####...#..###########.......##..###..####
#####.##.######################.....#####
#####....#######################...######
#########################################
