#########################################
###############...####...##.......#######
######.#########..###..#..##.....########
######.########.......#.#.#.......#######
###.......###...##...##...#.###.#.#######
###...........#####.#######.#.........###
###.......######............#.........###
###.......######.........#..#.........###
######.#########............#.........###
######.#########.........#..#.........###
######.#########.........#..#############
######..############.#####..#############
#######.######...###.#####..#############
#######..#####....##..#####.#############
########.####..##...#..##################
#####.......#..####..#...################
#####..........####.####.################
#####.......##..##.....#..###.......#####
#####.......###........##...........#####
###############..#.....######.......#####
###########......########################
##########......#########################
#########################################
