#########################################
###############...#######################
##############......#####################
#############..###.##########...#########
#############.##.......####.......#######
######.#####..##.......##...#.##.########
######.#####.###..........###.........###
###..........###.......######.........###
###.......#.####.......######.........###
###.........#######.#########.........###
###.......#########.#...#####.........###
###.......#########.#.#.##########.######
######.###########...#..#.#######..######
######.....#######........########.######
######......#####..####..#########.######
#####..####.#####.##.##..######.......###
#####.#####..###..#...#..######.......###
####..######...##.##.##..######.......###
####.##.######..#....##..######.......###
###..#...######.##......#################
####.##.##########.....##################
####....############...##################
#########################################
