#########################################
##########################...#.##########
#########################.......#########
########################.....#.##########
#####.......####.......##...##.....######
###........................##.......#####
#####.......#.##.......######.......#####
#############.###############.......#####
############..###############.......#####
###########..##################.#########
###########.#.#################.#########
#########...#..################.####...##
#########.####.################......#.##
########..####..#################...#...#
########.#####..#################.#.###.#
#####...........#############...........#
#####.......#...###.....#####.........###
#####...................#####.........###
#####.......#....##.....#####.........###
#####.......#....############.........###
#############.....#######################
#############...#.#######################
#########################################
