#########################################
#######...###############################
#######.##########################...####
###.........##################.........##
###.........################.......###.##
###.........#.############...#####.###..#
###...........############.###.......#..#
###.............#.......#..###.......#..#
#######.#######...........####.........##
#######...##..###.......#.####.......#..#
#######.....#...#########.####.......####
######..###...###########..##############
######..##################.##############
#####...##################..#############
#####.#.##################..#############
###.........#######.....##...############
###.........###.........##..#############
###.............###.....#...#.......#####
###.........#############...........#####
###.........#############..##.......#####
##########################.##############
##########################...############
#########################################
