#########################################
#############....###....##########...####
######.#####..##.###.##.########.....####
######.#####.##...#..#...#####....##..###
###.......#..##...##.#...####......##.###
###.........###...#..#...##....##.###...#
###.......######.##.####.#.....##...##..#
#.#.......######....###....##..#.....#..#
#.####.##########..###..#####........#..#
#..#...##########..###.######..##...##..#
#..#.#.########...###..######...##.####.#
#..##..########..####.#######...#..###..#
#..##.#########..#.......####...#.#######
#.....#########..#.......###..##..#######
##...##########..........###.####.#######
##...........##.##.......#...#.......####
####.#..........##.......#####.......####
######.......#.###############.......####
##############.###############.......####
##############################.......####
#########################################
#########################################
#########################################
