#########################################
#########...#############################
#########.###############################
######.......###...##############.#######
#.####...............###########...######
#..###.......#..####..###########.#######
##..##.......#..#####.##########..#######
###.####.#####.##.........#####.......###
###.......##...##.........###..........##
#####...##...####.................####..#
#######.##..#####.........#...##..####..#
######......#####.........#...##...##...#
#####.......###############....###.##.###
#####.........#############......#.######
#####.......#.##############..####.######
######......#..########...##..#.......###
##############..#######.......#.......###
###############...............#.......###
###############.#.....##.#....#.......###
#################.....###.....#.......###
########################......###########
######################...################
#########################################
