#########################################
#####.#########...###...##......#########
#####.##########....##....#.......#######
###.......#####.............#####.#######
###.......###...#####.##########.....####
###...........#####...#########.......###
###.......#####..#.....########.......###
###.......###...##.....########.......###
#####.##.##......##...#########.......###
#####.......####.###.####################
#####.......####...#.####################
######.##.#.####..##..###################
###.........####..#.#.###################
###.........####....#...#################
###.........####...####.#################
###.........########.......#######.######
###.........########...........##...#####
####################.......###..##.######
####################.......#.##....######
############################.##....######
############################......#######
#############################...#########
#########################################
