#########################################
###########...#####..........############
###########.######..#.......#...#########
########.......#.....###........#########
########.......#.##.####.######.#########
########.........##...#..##.........#####
########.......##.#...#..##.........#####
########.......#.........##.........#####
###########.####..##.##..##.........#####
#########...####.....#...##.........#####
########..########...#.########.#########
######...#########..##.########.#########
######.##########...###########.#########
###.......#######..###########...########
###.......#######..##.##########.########
###..............#.#...######.......#####
###.......#.....#..##.####.##.......#####
###...................####..........#####
###########.#####...######..#.......#####
##########..######..######..#.......#####
#########..#######.........##############
########..##########.......##############
#########################################
