#########################################
####...########........##################
##...#########......##.#######...########
##.###.......##...###...#####......######
#..#.#...........###.....####.####.######
#.#..........#######.....##...#.......###
#..#.################...###.###.......###
##...#.###############.##...###.......###
###.#...##############....#####.......###
###..#..##############.#.######.......###
####....#############..###...##.#####.###
####...##############.#..#............###
####.#.#############...#.#............###
####......##########.....##..#######..###
###.......##########.#####.#.#######.####
###.......#########......#...############
###.......########.......#..#..##########
###......#########...........#.#.....####
##################.......#...........####
###################.....##...###.....####
##########################.##############
########################...##############
#########################################
