#########################################
###############...##########...##########
######.######.......######.......########
######.######.#####.######.####.#########
###.....................#..#.........####
###.......#.###.........#.##.........####
###.........###...........##.........####
###.......#####.........####.........####
#.........#####.........####.........####
#.####.#########################.########
#......#########################.########
#......#######################...########
#..##...#####################.....#######
#.###..#####################..###.#######
######.#####################.####...#####
###.......#############......######.#####
###.......###########.......#######.#####
###..........##.....##############...####
###.......##...........###.#######...####
###.......#####.....##..#...######...####
#######################.##.##############
#######################....##############
#########################################
