NAME: ws_landmark_hall
TAGS: worked_stone room large landmark
WEIGHT: 3
EDGES: N door, S door, W door, E door
SUBST: ? = . . o
MAP
#####+#####
#.o.....o.#
#.........#
+....?....#
#.........#
#....?....+
#.o.....o.#
#####+#####
ENDMAP
