NAME: ws_medium_hall
TAGS: worked_stone room medium
WEIGHT: 8
EDGES: N door, S door, W door, E door
SUBST: ? = . o
MAP
####+####
#.o...o.#
#.?...?.#
+.......+
#.?...?.#
#.o...o.#
####+####
ENDMAP
