NAME: secret_cache
TAGS: room secret
WEIGHT: 4
MAP
#####
#?.?#
#.$.#
##+##
ENDMAP
